.....................................................................................................................................................
.....................................................................................................................................................
.....................................................................................................................................................
.....................................................................................................................................................
.....................................................................................................................................................
.....................................................................................................................................................
.....................................................................................................................................................
.....................................................................................................................................................
.....................................................................................................................................................
.....................................................................................................................................................
.....................................................................................................................................................
.....................................................................................................................................................
.....................................................................................................................................................
.....................................................................................................................................................
.....................................................................................................................................................
..............XX...............XX...............XX...............XX................................XX...............XX...............XX..............
.............XXXX.............XXXX.............XXXX.............XXXX..............................XXXX.............XXXX.............XXXX.............
...........XXXXXXXX.........XXXXXXXX.........XXXXXXXX.........XXXXXXXX..........................XXXXXXXX.........XXXXXXXX.........XXXXXXXX...........
..........XXXXXXXXXX.......XXXXXXXXXX.......XXXXXXXXXX.......XXXXXXXXXX........................XXXXXXXXXX.......XXXXXXXXXX.......XXXXXXXXXX..........
..........XXXXXXXXXX.......XXXXXXXXXX.......XXXXXXXXXX.......XXXXXXXXXX........................XXXXXXXXXX.......XXXXXXXXXX.......XXXXXXXXXX..........
...........XXXXXXXX.........XXXXXXXX.........XXXXXXXX.........XXXXXXXX..........................XXXXXXXX.........XXXXXXXX.........XXXXXXXX...........
.............XXXX.............XXXX.............XXXX.............XXXX..............................XXXX.............XXXX.............XXXX.............
..............XX...............XX...............XX...............XX................................XX...............XX...............XX..............
............xxxxxxxxxxxxxxxxxxxxxxxxxxxxxxxxxxxxxxxxxxxxxxxxxxxxxxxxxxxxxxxxxxxxxxxxxxxxxxxxxxxxxxxxxxxxxxxxxxxxxxxxxxxxxxxxxxxxxxxxxxxxx............
.............XXXX.............XXXX.............XXXX.............XXXX..............................XXXX.............XXXX.............XXXX.............
...........XXXXXXXX.........XXXXXXXX.........XXXXXXXX.........XXXXXXXX..........................XXXXXXXX.........XXXXXXXX.........XXXXXXXX...........
..........XXXXXXXXXX.......XXXXXXXXXX.......XXXXXXXXXX.......XXXXXXXXXX........................XXXXXXXXXX.......XXXXXXXXXX.......XXXXXXXXXX..........
..........XXXXXXXXXX.......XXXXXXXXXX.......XXXXXXXXXX.......XXXXXXXXXX........................XXXXXXXXXX.......XXXXXXXXXX.......XXXXXXXXXX..........
...........XXXXXXXX.........XXXXXXXX.........XXXXXXXX.........XXXXXXXX..........................XXXXXXXX.........XXXXXXXX.........XXXXXXXX...........
.............XXXX.............XXXX.............XXXX.............XXXX..............................XXXX.............XXXX.............XXXX.............
..............XX...............XX...............XX...............XX................................XX...............XX...............XX..............
.....................................................................................................................................................
.....................................................................................................................................................
.....................................................................................................................................................
.....................................................................................................................................................
.....................................................................................................................................................